1111111111111111111111111111111111
1E0000000000000C00000C000C00000001
1010010100100000101001000000010101
1010010010101010001001000000010101
1P0000000C00C00000C0000011000000C1
110000000000000C00000C000100C00001
1010010100100000101001000100010101
10100100101010100011110C0100010101
110000000C00C0000000000001000000C1
1111111111111111111111111111111111
