1111111111111111
1P00CCC1C0000001
1011101011111011
1000100000010011
1010111101111011
1010000000000001
1011111011101011
100C001010000C01
1111101011111111
1E00CCCCC0000001
1111111111111111
