1111111111111111111111111111111111
1P000001C000000C001000000100000001
1011101011111010111110101100011101
1000100000010010000010000001000C01
1010111101111011101011111011101101
1010000000010000001010000010000101
1011111011101011111010111011101101
100C001010000C01000000010001000001
1111101011111110111111001111011111
1E0000100000000000000C000000100001
1111111111111111111111111111111111
