11111111111111111111111111
1P0000000100110000C0000001
10111110111C11C10111111101
10100000001000000000000101
11101111101111110111110101
10C000001000100001000000C1
10111111111111101111110101
10000000000000000000000001
10111111111111110111111101
10000000C00000C00000000E01
11111111111111111111111111
