1111111111111111111111111111111111
1P000000010000000C0000000000000001
1011111010111101110111110111111101
1010000000100000000000000000000101
1110111110111110111111110111110101
10C00000100000001000000001000000C1
1011111110111111111111101111110101
1000000000000000000000000000000001
1011111110111111111111110111111101
1000000000000000C00000C00000000E01
1111111111111111111111111111111111
