111111111
1PC11CCC1
1CCCCC1C1
1C1CCCCC1
1CCCCCCC1
1CC11CCC1
1CCCCCCE1
111111111
